111111111111111111111
001010000000001000001
101010111011101111101
101010101000101000101
101010101110001010101
101000000010100010101
101110111110111110101
100010000000100010001
111011101111101011101
101000001000000010001
101111111011111010111
100000100000100010001
101011101110111110101
101010000010000000001
101010011011111111111
101010001000000000001
101111101111111111101
100000100000000010001
101011111111111010101
101000000000000000100
111111111111111111111
