111111111111111111111
000000100000000000001
111110101111101111101
100010100000100000101
101110101110111111101
101000100010000000001
101011111011111111101
101010001000001000101
101010001111101110101
101000101000001000101
101111101011101010101
100000100010000010101
101111111110111110101
101000100000000010101
100010101111111011101
100010001010000010001
101011111010111110111
100010000010100000001
101111101010101111101
100000001010000000000
111111111111111111111
