111111111111111111111
000010000010001000001
111010111010101010101
101000100010100010101
101111101111111110101
100000001000001000101
101111011110001011101
100010000000100010001
111010111111111110111
100010001000000010001
101110101011111011001
100010101010000010001
111011101011111110111
100000001000100010001
101111111010101011101
100000001010001000101
101011101011111011101
100000100010001010001
101010111110101010111
100010000000101000000
111111111111111111111
