111111111111111111111
001000000010000000001
101111101010100111101
100000101010100010101
111110101000111010001
100010101000001000101
101010101111111110101
101010101000000000101
101000101011111011101
101000100010001010001
101111111010101110111
101000001000100010001
101110101110111011101
101000100010001010001
101011111011101010101
100010001000101000101
111110101110101111101
100010100010001000101
101010101111111010101
101000100000000010000
111111111111111111111
