111111111111111111111
001000000000100000001
101111111010111011101
101000000010000010001
101011111111111110101
100010000000001010001
111110101010101010111
101000001010000010001
101010111011111111101
100010001000000000001
101111101111111010101
100010000000001010101
111010101110101010101
100010101000100010101
101110111011101111101
101000001000101000001
101111101110111011111
100010000010001010001
111010111011101011101
100000100000100000000
111111111111111111111
