111111111111111111111
000010000000000000101
111010101111101110101
101000000000001010001
101111110011111011101
100000000010000000001
101111111110111111111
101000001000101000001
101011101011101010111
100010100010000010001
101110111111111011101
100000100010001010001
111110101010101010101
100010101000100000101
111010001111111111101
100010100010100010001
101110111010101010111
101000100010001010001
101011101110111011101
100000001000001000000
111111111111111111111
