111111111111111111111
000010001000000010001
111011101010111010111
101000100010001010001
101110111111101011101
100000001000101000001
101111101000101111101
101000100010100010001
101010111110111011111
100010000010000000001
111111101011101111101
100000101010001000001
101110101010111011101
101000101010000010001
101010101011111010111
100010001000001000101
111010111111111011101
100010100000001010001
101111101011101010101
100000000000100000100
111111111111111111111
