111111111111111111111
000010000000001000001
101011101110101110101
101000000000100000101
101111111111111111101
100010000000100000001
101010101111101010111
101010100000001000101
101110111111111111101
101000100010000010001
101010101011101011101
100010000000001000001
101110001111111111111
101010100000000010001
101010111111111010101
101010101000001000101
101010101011101111101
101000001010001000101
101111111010111010101
100000000010000010000
111111111111111111111
