111111111111111111111
000000100000000000001
111110111010111110101
100010100010100010101
101110101111101010101
100000101000001010001
101111100011111010101
101000000010001010001
101111111110101010111
100000100000101010101
111110101111101010101
100010001000100010001
101111111110111111101
100010000000000000001
111010011011111011101
100010001000101010001
101110111110101010111
100010100000100010101
101010101111111110101
100000100000000000000
111111111111111111111
