111111111111111111111
001000000000000000001
101011111010101111101
101010001010001000001
101110101110111010101
100000101000101000101
111111101011101010101
100000100010001010001
101011111110111011111
101010001000001000101
101110101011101110101
100000101000100010101
101111101110101110101
101010001000100000001
101010101011111101101
100010101010000000101
111110111010101110101
100000100010101010001
101111101111101011101
100000000000001000000
111111111111111111111
