111111111111111111111
000010001000100000001
111010111010101111101
101010001010101000101
101010101010101010101
100000100010101010001
101111101110101011101
101000100010001000101
101010111110111110101
100000000010100010101
111111111011101000101
100000100010001010101
101110101110111010101
101000100000100010101
101011111111101010111
101000000000100000001
101111101110101011101
101000001000100010001
101011111111111010101
101000000000000000100
111111111111111111111
