111111111111111111111
001000001000000000101
101010111011111010101
101010000010000010101
101110101110111110101
100010101000100000101
101010100011101011101
101010001010001000001
101011111010111011111
101000000010100010001
101011111110111010101
101000000010001010101
101010111111101010101
100010000000001000101
101111110111111011101
100000100000000010001
111110111111101110101
101000100000100010101
101011101110111110101
100000001000000000100
111111111111111111111
