111111111111111111111
000000100000000000001
111110111011011110101
100010001010000000101
101011101011111011101
101010001000001000001
111010111110101110101
100010000010101000101
101111111011101011101
100000001000001010001
101011011111111011101
101000000000001000101
101011111111101110101
100000001000000010101
101110111011111010101
100010001010001010001
111010101010101011101
101010101010101010001
101011101010101110111
100000001000100000000
111111111111111111111
