111111111111111111111
000010000000000000001
111010110011101011101
101010100010100010101
101011101110111110101
100010001000100010001
101010111011101010111
100010001000001000101
101111101011101111101
100000101000000010001
111110101111111010111
101000101000000010001
101011101011111111101
101010001000100000001
101010111110111011101
100010001010001010001
101110101011101011101
101000101000001000101
101111101010101010101
100000001010000000100
111111111111111111111
