111111111111111111111
001000000010000000001
101010001110101111101
100010100000100000001
111110101011111010111
100000100010000010101
101111111010111110101
100000100010100010101
101011101110101010101
101000000010101010001
101011011110111011101
101000001000100000101
101111111011101111101
100000001010000010001
111111101011111010111
100010001000001010001
101010111111101011101
101010100000101010001
101010101110101010111
101000001000001000000
111111111111111111111
