111111111111111111111
001000100000001000001
101010111111101001101
101010000000100000101
101011111110111111101
100010000010000000001
111110111111111111101
101000000000100000001
101011111110101111111
100000000010101000001
101111111010100011101
101010000000101010001
101010101111101010101
100010101000001000101
111110101011011110101
100000101010000000101
101111101010111111101
101000001010100010001
101111111010100110111
100000000000100000000
111111111111111111111
