111111111111111111111
000000100000000000001
111110101010111101101
100010001000100000001
101111111111101111111
101000000000100010001
101011111110101010101
101000000010000010001
101111111011111110101
100010100010000010101
101010101111111010101
101000101000001000101
101111101011101110101
100000001010000010101
101111111011111011101
100010000010001000101
111011111000101110101
101010001000101000101
101010101111101010101
100000100000001000000
111111111111111111111
