111111111111111111111
001000001000000010001
101110101011111011101
100000100010001010001
111111111110111010111
100000100010000010001
111110001010111110101
100000101000100000101
101111101111111011101
100000100010000010001
101110111010101010111
100010000010101010001
111011101011101011101
101010101000001000001
101010101111111111101
101010100000001000001
101010111110111011111
100010001000100010001
101010101011101011101
100000001000000000000
111111111111111111111
