111111111111111111111
001000100000000000001
101010101111111111101
101010001000001000101
101011111110101010001
101000000000100010001
101111111011111011101
100010000010000010101
111010111110111110101
100010000010100000101
101111111010101011101
100000001010001000001
111011101111101011111
101000100000001010001
101010111111111011101
100010000010001000001
101110111110101110101
100010000010100010001
111011111010101110011
100000001000100000000
111111111111111111111
