111111111111111111111
000000100010000000001
111110101010111010101
100010001000001010001
101111111111101011101
100000100010101000101
101010101010101110101
101010001000100010101
111011111111111010111
100010000000000010001
101010111111111111101
100000100000001000001
101110101111101011101
100010001010001010001
101011111010111010111
101000000010000010001
101111101111111111101
101000101000000010001
101010101001011010111
100010100000001000000
111111111111111111111
