111111111111111111111
001000100000001000001
101010101111101010111
100000001000001010001
111111111011111111001
100000000010000000001
101111111110011011101
101000001010001010001
101110101011101011101
100000101000001000101
111111101011111110101
100010001000101000101
101010111110101011101
101000100010001010001
101010101011101011101
101010101000001000101
111010111110111110101
100010100010100000101
100110101011101110101
100000001000001000000
111111111111111111111
