111111111111111111111
000010000000000000101
111011101111111110101
101000101000100010101
101110101010101010101
100010001010001000101
101111011011111111101
101000001010000000001
101010101011101110101
100010101000000010101
101110111110111011101
101010001000000010001
101011101011111110111
100000101000100000001
111110101010101111101
101000100010101010001
100011111010101010111
100010001010100010001
101110101010111111101
100000100000000000000
111111111111111111111
