111111111111111111111
000000100000000000001
111110101111111111101
101000101000000010001
101011101110101110101
100010100010100010101
101010111011101010111
100010001000000010001
101110111111101111101
101010000000001000001
101000111110111011101
101000100010001000101
101111101011101110101
100000101010100010101
111010101010101110101
100010001010001000101
101011111011111011101
101000000010000010001
101110101110111110111
100010000000100000000
111111111111111111111
