111111111111111111111
000010000010100000001
111010111010101110101
100010100010000000101
101110101110111011101
100000100010100010001
111110111011101110111
101000100010001000101
101010101110111011101
101010100010001000001
101010111011101110101
100010001000001000101
101110101111011011101
100010100000001000101
101010101010111110101
101000101010100000101
101011101010101111101
101000101010101000001
101110101011101111101
100010001000000000000
111111111111111111111
