111111111111111111111
001000000000100000001
101111111010111011101
100000001010000010001
111111100011011110111
100010000010001000101
101110111011101011101
100000100010001000101
101111101110111110101
101000000010000010101
101110111010111010101
100010001010001000101
111011111011101111101
101000000010000000101
101111111110111010101
100010000010001010001
101010111011101011101
101010101000100010001
101110101110111110101
100000000010000000000
111111111111111111111
