111111111111111111111
000010000000000000001
111010101111111110001
100010100000100010001
101110111110111010101
100010000010001000101
111011101111101011101
100010001000000000101
101111111011111110101
100010000010000010101
111010101110111010101
101010101000001010001
101010111011111010111
100010000010000010001
101111111110111111101
100010000010100000101
111010111010111011101
100010100010100010001
101000101110101110111
100000100000100000000
111111111111111111111
