111111111111111111111
001000000000000000001
101001111111101111101
100000000000100010001
111111111110101010111
100000100010100010001
101100111000101111101
101000000010001000001
101111111011101011111
100010000010001000001
111010111111101111101
100010000000000010001
101011111111111010111
101010001000000010101
101110101011111010101
100000101010001010001
101111101010101011101
100010001010101010001
111010111110101110111
100010000000100000000
111111111111111111111
