111111111111111111111
000010000000000000001
111011101010111111101
101000101000100010101
101110111110101010101
100010000010001010101
101011111011111010101
100000001000100010001
101011111110001110111
101010000010001000101
101110101011111011101
101000101000100010001
101011101011101110111
100010100000001000001
101110111111111110101
100010000010000000101
111010111010101110101
101010001010101000101
101011101011101011101
100000001000001000000
111111111111111111111
