111111111111111111111
000010000000000000101
111011111011111110101
100000000010000010101
101111011110101010101
100000000000100010101
101110111111101110001
101010100010001010001
101010101110111011101
100010100000000000101
111110101111111011101
100000101000001010001
101111101011101110111
101000101000100010101
101010111110111010101
100000000010001010001
101111110011101011101
100000100000101010001
111110101111101010111
100000100000001000000
111111111111111111111
