111111111111111111111
000000000000001000001
111111111110101111101
101000000000100010001
101011001111111010111
100000001000100010001
111110001010101110101
100000101010001000101
101111101011111111101
101000101000000010001
101010111111111010101
100010000010000010001
101111101010111111101
100010001010000010001
111110101111111010111
100000101000100010001
101011111010101111101
101010001010001000101
101110101010101010101
100000100010000010000
111111111111111111111
