111111111111111111111
000010000000000000001
111010111111111110101
100010100000000010101
101110111101101110111
100010000000100010001
101011111110111011101
101000100000100000101
101011101111101111101
101000101000001000101
101010101011111010101
101010101010000010001
101010101010111111101
101010100010001000101
101010111011101011101
101010000000101010001
101111111111101010111
100000000000000000001
111111101010111011101
100000000000100000000
111111111111111111111
