111111111111111111111
001000000010000000001
101011111110111110111
101000000010100010001
101111101010001111101
101000101000100010001
101010111110111010101
101010000010000010001
101011111011111011101
101010100010001000101
101010101110101110101
101010100000001010101
101010111111101010101
100010000000101000101
111110101011101111101
100010001000100000001
101010101110111111101
101000100010000000001
101110111011111111111
100000000000000000000
111111111111111111111
