111111111111111111111
000000000010000000101
101111111010111110101
100000001000100010101
101011111111111010101
101010001000000010001
101010101010111011101
101000100010100000101
101010101110111011101
100000100010001010001
101111101011101110111
101000001000100000101
101111111110111111101
100010000000000010001
111010111110111011101
101000100000001000101
101111101011111110101
100000001000000010101
101111111111101010101
100000000000001000000
111111111111111111111
