111111111111111111111
001000100000100000001
101010111110101011101
100010000010001010001
111111111011101010111
100000001000101010001
101010111110101011111
101000100000101010001
100011101111100010101
101000101000101000101
101110101010101111101
101000100010101010001
101001111110101010111
101000000010100010001
101110111010111111101
101000100010000010001
101011111111111010101
101000000000001010001
101010111011111011101
101000001000000000000
111111111111111111111
