111111111111111111111
000000101000100000001
111110101010101010011
100000100010100010001
101111111010111011101
101000001010000000101
101011101011111110101
100010001010000000001
111110111010111111101
100010100010100010001
101110111110111010111
100010000010001010101
101011111010100010101
101000001010101000101
101110111010101011101
100010001010001000001
111011101011101111101
100010100000001010001
101110101111111010111
100000100000000000000
111111111111111111111
