111111111111111111111
000000100010001000001
101110111010101010111
100010001000101010001
111011101011101011101
100010101000100000101
100010101110110111101
101000101000100000001
101011101111101111101
101010001000001000101
101110111011111010111
101000100000000010001
101011111111111111101
101000001000000000101
101111001011111110101
100010001010001010001
101010111000101011101
101010100000101000001
101010111111101001111
101000000000001000000
111111111111111111111
