111111111111111111111
000010000010100010001
111011101010101000101
101000001010101000101
101111111010101111101
101000001010001010001
101010111010111010101
100010001010000010101
101111101011111000111
101000001000000010001
101011111110111111101
101010000010100000001
101010111010101111111
101000101010101000001
101110101010101011101
101000001000100000101
101011101111111111101
101010001000100000101
101010101010001110101
100010000010001000000
111111111111111111111
