111111111111111111111
000000100000100010001
111110101110101010101
100010100010001000101
100010111011111111101
101010000010000000001
111011111110101111111
100010000010100010001
101110111010101011101
100000100010001000001
101111101011011111101
101000100010000000001
101010101010111011111
100010101000100010001
110110101110101110101
100000100010100010101
101111111011111010101
100010001000001010101
111010101111101011101
100000100000100000000
111111111111111111111
