111111111111111111111
000010000000100010001
111010111110101011101
101010000010001000101
101011010010111110101
101000000010100010001
101111111110101010101
100000100000101000001
101110111010101111111
101000001010100000001
101111101110111111101
100010100000000010001
101010111011101110111
101010000010001000101
101011111010101011101
101000001010101000001
101111101010101110101
101000101010100000101
101110101110111110101
100000100000000010000
111111111111111111111
