111111111111111111111
001000000000100000001
101110111110101110101
100000101000101000101
111111101011101011101
100000001000001010101
111011101110111010101
100010000010000010001
101110111111111010111
100000000000000010001
101111110111111011101
101000100000001000001
101010101111101111111
101010001000000000001
101011111011111110101
101000100010000010001
101011101110101110111
101010001010000000101
101110111010111111101
100000100000000000000
111111111111111111111
