111111111111111111111
000010000010000000001
111011111000111011101
101000001000100010001
101111101111101110111
100000100010000010001
101110111010111011101
101000101000100010001
101110101111111010101
100010001010000010101
101011001010101010101
101010000010101010001
111010111110101111101
100010001000101000101
101111111011101010101
100010001000101010101
101010101110101010101
101000100010101010001
101011111010101011111
100000000000100000000
111111111111111111111
