111111111111111111111
001000000000000010001
101011101111111011101
101000001000100000101
101111101010111110101
100000100010001000001
111110101111101111101
101000101000001000101
100011111011111010111
101000000010000010001
101111101010111110101
101000001000100010101
101011111111101011101
101000100000101000101
101110100010101110101
100000101010001010001
101101111011111011101
101000000010000010001
101100111110111110111
100000100000000000000
111111111111111111111
