111111111111111111111
000010000010000000001
111010111010111111101
100010001000100000101
101011101110101110101
100000100010101010101
110110111011101010111
100010001000000010001
101011101110111111101
101010001000000000001
101010111011111111101
101010000010100000101
101010111110101110101
101000000010101000001
101111101010101011111
100000101000101000001
111110101111101110101
100000101000001000001
101111101011111011101
100000100000000010000
111111111111111111111
