111111111111111111111
001000001000001000001
101010101110101011101
101010100000101000101
101010111110101111101
101010100010001000001
101110111010111011101
100000100010000000101
111111101010111110101
100000101010000010101
101110101011111010111
100010001000100000001
111011111110101111101
100010000000101000001
101111101111100011111
100000100010000010001
101110110110111010101
101000100000100000101
101011101111111111101
101000000000000000000
111111111111111111111
