111111111111111111111
001000000000001000001
101010111111101111101
101000100010100010001
101011101010111010001
101010001000101010101
101010101010101010101
101010101000001000101
101011101011111111101
100010001010000010001
111110101110101110111
100000101000100000101
101010101011111111101
101010100010000000001
101010101010111111101
101010001000000000101
101011101111111110101
101000100000000010101
101110111111111010101
100010000000000000100
111111111111111111111
