111111111111111111111
001000001000000000001
101110101111111110111
100010100000000010001
111010111111111010101
101000100000001010101
101000101111101010101
100010101000001010101
101110111011101011101
101000001010001000001
101011101010011111101
101010001010000000101
101010111011111011101
100010100000001000001
111010111011101010111
100010001010101010101
101111101010101110001
101000101000100010001
101010101110111011101
100010001000001000000
111111111111111111111
