111111111111111111111
001000001000000000001
101110101110111111101
100000100000100000001
111111111011101111101
100010001000100000101
101110101110111110101
101000101000100000101
101011101011101111111
101010100010000000001
101010111010111111101
101010000000000000101
101011101111111111101
101000100010001000101
101010111110101010101
100010100010100010101
101010101010111110101
101000101010100010001
101010101010101110001
101000001000100000000
111111111111111111111
