111111111111111111111
000000100000100000001
111110101110101110101
101000101000001000001
101011101011111110111
101000101000100010001
101110101111101011111
100000101000001000001
101011101011111111101
101000000000100000001
101111101111101111101
100000101000101010001
111110111010101010111
100010000010001000101
101110111111111011101
100000000010001010001
101110001010101010101
100000101000101010101
111010111011101011101
100010000000100000000
111111111111111111111
