111111111111111111111
000010100000000000001
111010001110111111101
100010100010100000101
101110101110101110111
101000001000100010001
101110111010101111101
100010001010101000001
111011111011101010101
101000001010001000101
101111101010111110101
100000101000001000101
101110101010111011101
101010001010000010001
100011111010110110111
100010000010100010101
111010111110101010101
100010001000001010101
101111111011101110101
100000000010000000000
111111111111111111111
