111111111111111111111
001000000000000010001
101010111110101110101
100010100000100000101
111110101111101011101
100010100000100010001
101110101110101110101
101000101000101010101
101011101011101010101
100000000000101010101
101110101110101010101
101000100010100010101
101011101010111010111
101000101010000010001
101110101011111111101
100010001010000000001
111011101110111111101
101000101000101000001
101110111011101011111
100000000010000000000
111111111111111111111
