111111111111111111111
000000000000000000101
111110101111101100101
100000101010001000001
101111101010111011111
100000101010100010001
111110101010111110101
100000100010000000101
101111111011111111101
101000001000101000101
101011101110101010101
100010001000001010101
111110111111101010101
100010000010001010001
101011111011111011101
100000001010001010001
101101101010101010111
101000000010100010001
101010110110111111101
100010000000100000000
111111111111111111111
