111111111111111111111
000000100000000000001
111110111110111111111
100010100010000000001
101010101011111111101
101010001000100000001
101011111110101111101
101010000000101000001
101010101111101111101
101010000010001000101
111011111011101010101
100000001000100010001
100111111110111110001
100000100000100010101
101110101010101011101
100010001000101010001
111011111010101010101
100010100010001010101
101110101111111010101
100000100000000000100
111111111111111111111
