111111111111111111111
001000100000000000101
101010101110111110101
101010001000000010001
101011111011101011101
101000100000101000101
101110111111101111101
100010100000101000001
111010101010101011111
100010100010000000101
101110101011101110101
101000101010000010101
101110101010111110101
100000101010100010001
111110101010101010101
100010001010101000101
101110111011101111101
101000101000001000001
101011101110111011101
100000000000000010000
111111111111111111111
