111111111111111111111
001000001000000000001
101111101011101011101
100000100000000010001
111110111110111110101
100010001000100000101
101111101111101111101
100000101000001000001
101011101011111011111
101000001000101000001
101011111110101111101
101000000000100000001
101110111011101111111
100010100000100000101
111010111110111010101
101010000010100000101
101010111010101111101
101010100010001000001
101010101110111011101
100000001000000010000
111111111111111111111
