111111111111111111111
001000000000000000001
101011111111111111101
101000100000000000001
101110101110101111101
101000101000001000101
101111101011101010101
100000001010001000001
111111111010111011101
100000000010100010001
101111111110101111101
100000000010101000001
111110111010101011101
100000001010100010101
101111111010111110101
101000001000100010001
101011101111101010111
101010100000101010101
101010111110101000101
100000000010001000000
111111111111111111111
