111111111111111111111
000000001000001000001
111111101110001011111
100010001000100000001
101110101011111110101
100010100000100000101
101010111010101111101
101010001010001000101
100011101011111010101
101000001000101010101
101111111010101010101
101000001000100010101
101010101110111110101
101010100010000000101
101110111010111111101
100000000010100000101
111111101111101110101
100000001000101010001
101111111010101011101
100000000010001000000
111111111111111111111
