111111111111111111111
001000001000100000001
101011101010101010101
101000101010000010101
101010111011111110101
101010000000000000101
101011111110111111101
101000000010100010001
101111101010101011111
100010001010001000001
111010111011111111101
100010000000000010001
101110111111111110111
100010100000000010001
111011101111111011101
101010001010000000001
101010111010111110101
100000100010100000101
101111101110101111101
100000000000000000000
111111111111111111111
