111111111111111111111
000010000010000000001
111011101011101011101
100010001000101000001
101010111110101011111
101010100000101010001
101010001111111010101
101000100010000010101
101111111011101110101
101000001000101000101
101011101110101011101
100010100010101010001
101110111010101010101
100000001000100000101
101111101111111010111
100000001000001010001
110111101110101011101
100000100010101010001
101011111010101110101
101000000000100000100
111111111111111111111
