111111111111111111111
001000001000000000001
101110101011101111101
100000101000100010001
111110101010101011111
100010001010001000001
101110111111101101101
101000100000101000001
101011111010111011101
101010000010001010001
101010111111101010111
100010100010001010101
101110101110011010101
101000100010000010001
101011101011111111101
100010101000001010001
111110101110101010111
100000101010100010001
101110101010101111001
100010000010000000000
111111111111111111111
