111111111111111111111
000000000000001000001
111111111111101010101
100000100000101000101
101110101110101110101
101010101000100010101
101010101111111010101
101000001000000010101
101011101011111110111
100010101010000010001
101000101010111011101
101010001010001000101
101011111010101110101
101000000010100010101
101111111111111010101
101000000010000000101
101111101010111110101
100000101000100010001
110110101111101010101
100000001000001000000
111111111111111111111
