111111111111111111111
001000100000000010001
101010101111111010101
101000100010000010001
101010101011100111101
100010101000100000101
111110111110111110101
100000100000100000001
101111101111111111101
101010000000000010001
101010111111111010111
101010100010001010101
101010101010101010101
100000101000101000101
101110101011101010101
100010101010100010001
111010101010111111101
100010001010000000101
101111111010111110101
100000000010000010000
111111111111111111111
