111111111111111111111
001000001000001000001
101010101110111000001
101010100010000010101
101110111010110110101
100000100010000010101
111111101111111010111
100000101000001010001
111011101110101110101
100010001000100000101
101010111011111110101
101010000010000010101
101110101110101010101
101000100010101010101
101011111010101010101
100010001010101010101
101110101011101110101
100010001000100010101
111010101110101010101
100000100000101000000
111111111111111111111
