111111111111111111111
000010000000000010001
111010101111111011101
100000101000001010001
101111101010101010111
100000100010101010001
101110101110101011101
101000101010101010001
101110101010111010101
100000100010001000101
111010101011101111101
100010101000100000101
101111101010101110101
101000001000100010001
101011111010111011111
100010000010001000101
101110111111101010101
100000100000100010101
111111101011111110101
100000001000000000000
111111111111111111111
