111111111111111111111
001000001000000000001
101110111011111011101
100010000010000010001
111010111110111110111
101010100010001010101
101011101011101010101
101000001000001010101
101111011111111010101
100000000010000000101
101111111010111111101
101000100010001000001
101010101111101011101
101010100000101010001
101010110110101110101
101010100010000000101
101010101011111101101
101010101000001000001
101010001010101011111
100010001000100000000
111111111111111111111
