111111111111111111111
000000001000000000001
111111101010111111111
100000001010000000001
101111111110111111101
101000000010001010001
101111101011101010101
101000101000101010101
101010101110101010111
101010001010100010001
101011111010111010101
101000001000100000001
101111101011101110101
100010001000100000101
101010111110111011101
101000100010100010001
101111101010101110111
101000000010001010001
101011101111111011101
100000000000000000000
111111111111111111111
