111111111111111111111
000010000000001000001
111011111011101111101
101010001000100000101
101010101110101110101
100010100010100010001
101110111010101011101
100000101000101000101
111111101111101011101
100000001010001010001
101110101010111010111
101000100010101000101
101011111110101110101
101000100000100000001
101110101111111001101
101000100000001000001
101011111111101110101
101000000000001000001
101111111011111011101
100000000000000010000
111111111111111111111
