111111111111111111111
001000000000001000001
101010111111101011101
101010001000101010001
101010101110101110101
100010100010100000101
111010101010111111101
101000100010001000001
101011101110111011111
101000001010000010001
101111111010111111101
100000001000100000101
100011111011101010101
101010001000101010101
100010101110111010101
101000100000100010001
101111111111101111101
101000001000001000101
101110101111101010101
100000100000000010000
111111111111111111111
