111111111111111111111
000010100000001000001
111010101111101010111
100010001000100000001
101110111000111111101
100000001010000000001
101111111011111111101
100000001000101000101
111111101010101010101
100000101010100010101
101110101110101110101
101010001000101010001
101011111011101011111
101000000000101000001
101111101100101110101
100000101000100010101
101110111011111010101
100010100010001000101
101110101010111111101
100000001000000000000
111111111111111111111
