111111111111111111111
000010000000001000001
111010101110101010011
101010100000101010001
101010111101101011101
100010001000001010101
101110101011111010001
100010101010001000101
111010101110101100101
100010100010100000101
101111101010111110101
100000101010100010101
111110101010101011101
100010101000101000001
101010111011101111101
101000001010001000001
101111101110111011111
100000100000101010001
101110111111101010101
100010000000000000100
111111111111111111111
