111111111111111111111
000010000000000010001
111011101011101010101
101000001010001010101
101111101110101010101
100000101000101000101
101110101011101111101
100010101010000000101
101011101010111110101
101010001010100000101
111010111010101110101
100010100010100010101
101010101111111011101
100000100000000010001
101111111010101110111
101000001010100000101
100011101110101111101
100010001000100010001
111110011011111011101
100000000010000000000
111111111111111111111
