111111111111111111111
000000000000000010001
111111101010101010101
100010001010101000101
101010111010111010101
101010000010001000101
101011011111101111101
101000001000101000101
101011111010101010101
101000001010001010001
101111101011111011101
101000000010000010001
101011101010111010111
101000101010101010001
101110101010101011101
100010101010001010101
101110101011111010101
100000101000100010101
101111111110101110101
100000000000001000000
111111111111111111111
