111111111111111111111
000010000000000000001
111011111111111110101
100010000000000010101
101110111111111010111
100010000000100010001
111011111110111011101
100010000010001000001
101110111010101010101
100000101010101000101
111111101011101111101
100000001010001000101
111010111010111010101
100010100010100010101
101111101110111010101
100010001000100010101
101010111011101110101
101000100000101000101
101110111100100010101
100000000000100000000
111111111111111111111
