111111111111111111111
001000100000000010001
101010101011111010111
100010101000100000001
111110111110111011101
100010100010001000101
111010101011101110101
100010001000100010001
101111111010110011101
100000000010000010001
101111101111111110111
101000100000000010001
101110111110111111101
100010000010000000001
111010111011111111111
101000000000001000001
101111111111101011101
100000001000001000101
101111111010111110101
100000000000000000000
111111111111111111111
