111111111111111111111
000000000000100000101
101010101110111010101
101010100010000010101
101010101011110110101
101010001010000000101
101111101011101111101
100000101000101000101
111110111010101010001
100010001010100010001
110011101110111111101
100010001000100000101
101110111011101011101
100000100010001000101
101111101110111110101
101000001010100010001
101011101010111011111
101010001010001000001
101110111011101110101
100000100000000000100
111111111111111111111
