111111111111111111111
001000000000100000001
100011111110101110101
101000000010001000001
101111101111111011111
101010001000001000001
101010111011101011101
101000001010001010101
101111111011101010101
100000001000101000101
111111101010101011101
100010001010100000001
101010111110111011101
101010000010100010001
101111111010101110111
101000000000100010001
101010101111111011101
100010000000000000101
101110111111111111101
100010000000000000000
111111111111111111111
