111111111111111111111
001000100000000000001
101010101110111111101
101010001000100000101
101011111001101111101
101010001000100000001
101110101110111011111
100010100010001010001
111010111010101011101
101000101010101000101
101111101010101110101
100000101010101000101
100010101010101011101
101010101010101000101
101010101010101110101
101010101000100010001
101010101010101011111
101010001010001000001
101011101010101111101
101000000000100000000
111111111111111111111
