111111111111111111111
001000001000000000001
101011101011101011111
100010101000100010001
111110101111101000101
101000101000001000101
101010101010101110101
100010001010001000101
101111111011111011101
100010000010000010001
111011101110111110111
100010001000100010001
101110111011101011101
101000000000001000101
101111111111101111101
100010000010001000001
111010111011101011111
100010101000001000001
101110101101101111101
100000100000000000000
111111111111111111111
