111111111111111111111
000010100000001000001
111010101011101110101
100010101010001000101
101110100000101011101
100010101010100000101
111010101010111110101
100010001010000000101
101011111011111111101
101000001010000000101
101101101010111110101
100000100010100010001
101010111110101011111
101010000010001010001
111011101111111010101
100010001000001010101
101011111011101011101
101010001000100010001
101110101110110110101
100000100000000000100
111111111111111111111
