111111111111111111111
001000000010000000001
101011111010111110101
100010000010101000101
101010111110101010101
100010000010001010001
111111111011101011111
100000001010001000001
111111101011101111101
100000101000101000101
101110101110101100101
100010000010101000101
111011111110101011101
100010000010100010001
101110111010111110101
100010001000100000101
101010101111101111101
101010001000001010001
101010101110101010111
101000000000100000000
111111111111111111111
