111111111111111111111
001000000010001000001
101011111010101011101
101010000010101000101
101010111010101011101
101000100010100010001
101010101010111110111
101010001010100010001
101111101010101000001
100000101010101010101
101010111010101011101
100010001010101000101
111011101010101110101
101000001010100010101
101011111010111010101
100010100000100010101
101110101111101110101
101000000010001010001
101111111110111011101
100000000000100000000
111111111111111111111
