111111111111111111111
001000000000100000101
101111111010111010101
100000001010001010001
111111101011101010101
100000101000101000101
111110101010101110101
100010001010100000101
101010101110110111101
101000100000100000001
101011111111101111111
101000000000000000001
101011111011111111101
100010000010000000101
111110101110101110101
100000101000101000101
101110111011101110101
100010100000100010101
101011101110111011101
101000000000001000000
111111111111111111111
