111111111111111111111
001000000000100010001
101111101110101011001
100000001000101000001
111111111011101111011
100010001010000000001
101010101011111111101
101000101010000000101
101111101010111110101
100000101000100010001
111110101111101111101
100010100000001000101
101010111110111010101
101010000010000000001
101111111011111111111
100000001010100000001
101111101010101011101
101000101010000010001
101110101011001110101
100000100000000000100
111111111111111111111
