111111111111111111111
000010100010000000001
111010101000111111101
100010001000100000101
101111111010101110101
101000100010101000101
101010101011101110101
100010101000100010001
111110001110101010101
100010100010101000101
101010111010111010101
101010000010000000101
101111111111111111101
100010000000001000001
111010101010101011111
100010101010100010001
101110101010111111101
100010101010000010001
101010101111111010101
101000100000000000100
111111111111111111111
