111111111111111111111
001000001000000000001
101110001111111010111
100010100000001010001
111010111111101111101
101000100000100010001
101111111010111010101
100000001010001000101
101110101111101111101
101000101000100010001
111011101000101010011
100010100010001010001
101110110011111111101
101000000010000000001
101110111110111111111
100010001000100000001
101011111011101111101
101000001000101000001
101101101110111011101
100000100000000010000
111111111111111111111
