111111111111111111111
000010001000000000101
111010101011111010001
101010101010001010001
101010101110101011101
101000100000100010101
101111111111111110101
100000000010000000101
101111101110111000101
101010001000000010101
101010111011101110101
100010001010100010101
101111101010111010101
101000001000100010101
101011111011101011101
101000100010001010001
101110101110111010111
101000101000100010001
101011101010110111101
100000001000000000000
111111111111111111111
