111111111111111111111
000000001000000000001
111111101110111111101
100000100010100000101
100011111010111010101
100000000010001010101
101111101111101011101
101000000000001000101
101111111110111010101
100000001000100010101
111010101011111110101
101000101000000010001
101111101111111010111
101000001000000010101
101011111011111110101
100010000010001000101
101110101110111011101
100010101000001000001
111011101001101101101
100000001000100000000
111111111111111111111
