111111111111111111111
000000100000000000001
101010111110110111101
100010001000100010001
111111101011101010111
100010001000001010001
111010111010111011101
100010001010001010001
101110101010111010111
100000100000100010001
101111111110101111101
100010000000001000101
111011101111101010101
101000001000001010001
101111111010111011111
100000000010100010001
101111111111101111101
101000001000100000001
101011101010111111101
100000100010000000000
111111111111111111111
