111111111111111111111
000000000000000010001
111011111111101010101
100010000000001010001
101110111110111010111
101000100000001010001
100011101111101010101
100010101000100010101
111110101010111111101
100010001010000000001
101110111011101111111
100010100010001000001
101010101110111011101
101010100010100000101
111010101011101110101
100010101000001000101
101110101111011010101
101000101000001010101
101011111011101010101
100000000010000010000
111111111111111111111
