111111111111111111111
001000000000001000001
101011111110101111101
101000001000100010001
101110111011111010111
100010100010001010001
111010101111101011101
101000101000001010001
101010100010111010101
101010101010100010101
101011101010101110111
100010001010101000001
101110111011101111101
101000100010000000001
101011101010111011111
100010001000100010001
111110111111100110101
100010000000100000101
101011110110111110101
101000000000000000000
111111111111111111111
