111111111111111111111
000010000010000000101
111011101011101110101
100010001000001000001
101010101111111111001
100010101000100010001
111010111010101011111
101010000010001010001
101011111011111010101
101010001000001000101
101010101111111111101
100000100000001000001
101110111111101011101
101000100010000010001
101000101011111110111
100000001000000010101
101111111111111010101
100000000010000010101
111111111010111110101
100000000000100000000
111111111111111111111
