111111111111111111111
000000100000001000001
111110111111101011101
100010001000100010001
101011101010111010101
100000101010000010101
101110101011111010101
100010100010001000101
111010111110111111101
100010001000001000001
101011101011101011111
100010000000101000101
111010111110101110001
100010100000100010101
101110101111101110101
101000100010001000101
101010111010111010101
101010001010001010001
101011111011101011101
101000000000100000000
111111111111111111111
