111111111111111111111
000000100000000010001
111000101111111011101
101000100000001000001
101011101111101111111
101010000000100000001
100010111010111111101
100010100010001000001
101110111110101011101
101010100010101000101
101010101011101110101
101010101010000000101
101010101010111110111
101000001000100010001
101111111110101011101
101000100010101010001
101010001010101010101
101010101000101000101
101010111111101111101
100010000000001000000
111111111111111111111
