1111111111111111111111111111111111111111111111111111111111111111111111111
0010000000001000000010001000000000000000001000100000000000000010000000001
1010100111101010111010101110111011111111101010111111101111111010111010101
1000100010001010101010000000001000000000100010000000100000100010100010101
1101101010111110101010111111101011111110111111111110101110001111101011101
1000001010100000101010100000101000000010100000000010100010101000001000001
1010111010101111101010101111101011111010101111111010111110101011111110101
1010101010101000001010101000001010001010101000000010001000100010000000101
1110101010101111101010101011111110101010111011111011101011111010111101101
1000101010001000001010101000000000101010001000101000101010000010001000001
1011101011111011111010101111111111101111101010101011101010111110101011111
1000100010001000001000101000000000100000001010100010001010100010100010001
1000101111101011101111101010111111101111111010111110111000101010111110101
1010100000101000100000100000100000000010001010000010000010101000100000101
1010111110101110101110101110101110111010101011101011111110101111111110001
1010001000000010100010100010101010100010101000001000001000001000000010101
1111100000111110111011111010101010111010101111101111101011111011111011101
1000001000100010001010001010101010001010101000001000101010000010001000001
1011111111101011101010101010101011101110101011111010101010111110101111101
1000100000001000001000100010101000100000100010000010000010100010100000101
1010101111111111111111111110101110111111111111111010111110101010101111101
1010001000000010000010000010100010000000000000001010000000001010101000101
1011111011111011111010101110111010110110111111100011111110101010101010101
1010000010001000001000100010000010000010001000101000001000101010101010001
1011001110101110101110111011101011111011101010101111101011101110101011111
1000001000100000100010100010100010001010100010100010001010000000101010001
1111111011111110111011101010111111101010111110111010111010101111101010101
1000000010001000101000001000000000100000001000001010001000100010100010101
1011011110101010101111111110101110101111111011101011001110111010111110101
1000001000100000100000100010101000100000001010000010001000100000000010101
1111111011110110111010101010101011101110101011101110111011111111111010111
1000001010000010001010101010001010001000001000100000001010001000000010001
1011101010111011101110101011111010111011101010101111101010101101101111101
1000100010101010000000101000100010101010001000000010101000100000100000001
1010111110101011111111101011101110100010111011111010101111111110101111111
1010000010101000000000001000001010001010100010100010000000100000101000001
1011111010101111111111111111111010111010101010101110111110101111111011101
1010100000000010000010000000000000100010101010101000000010100010000000101
1010101111111011111010111111111111101110111010101011111010111010111101101
1000100000101000100010000010001000001000000010001010000010001000001000101
1011111010101110101111111011101011111111111110101010111111111111101010101
1010000010001010001000001000001000001000100000101010100000000010001010101
1010111111101010101010111110111111001010111110101010110110111010111010101
1010100000000010100010001000100010001010001000100010000000100010100010001
1010101111111010101110101011101010100011101011111111111111101110101111101
1000101000100010000010100010101000101000101000000000001000100010101000001
1010101010111011101010111010101011111011101011111010111010111010101011111
1010001010001000100010000000101010000010001000001010100010001010101000101
1010101011101111101111111011101010111110101111101011101110101011101110101
1010001000101000001000001010001010100010100010000000000010101010001000101
1010001110101011111011101110101110101010101011111011111110111010111001101
1000100010100010000000100000101000000010101000000000100010100010001000101
1010111110111110101110111011111011111110101110111110101010101111101110101
1010100000100000000010101010001010000000100000100010101010100000001010001
1010101011111111101010101010101010110111111110111010101010111001111011101
1010100010000000101010000010100010100010000010000010001010000000100000101
1011111010111110101000101110111110101010111011111011111010101110111011101
1000001000100000100010101000100010001000001000000010001010100010001000101
1011101111101111111010111011101011111111111111111110101010111011101110101
1000000010101000101010100010001000001010000000100000100010001000100010001
1011111010101010101010101110111111101010111010101111111111101110101010101
1000001000101010101010101000100000000010100000001010000000101000100000001
1010101110101010101010101010101111101110111111011010111110101011111111101
1000100010100010100010101010101000101000100000001000001010101000001000001
1110111011110110101110101110111010111011101101101111100010101111101010101
1010001000000010100010100000100010001000001000100010001010001010000010101
1011101111101110111010101110101111101111101010111010111011111010111000101
1000100000100010001000000000101010001000100010001010100000100000000010101
1010101110111011101111111111101010111010111011111010101110101011111110101
1010101000000000100000100000101000100010100000000010001010001010001010101
1010101011111111111100101110101011110010101111111110101011011010101000101
1010001000000000000000001000001000000010001000000000001000000000100010000
1111111111111111111111111111111111111111111111111111111111111111111111111
