1111111111111111111111111111111111111111111111111111111111111111111111111
0000100010000000100000100000001000000000000000101000100000100000100000001
1110101011111000111010101110111010111111111110101010101110001011101011101
1010101010000010001010101010001010001000001000000010001010001000001010101
1010101010101011101011101011101011101111101011111011111010111111111010101
1010001000100010001000000000101000100000100010001000000000001000100010101
1011111111111110111111111110100000111110101110101111110111101011101110101
1000001000000010000000001000100010000010101000101000000000000010001000101
1011101011111010101111101010101110111010101110001111101111111110111011101
1000101000001000100000100010100000100010100000100000101000000000100000001
1110101111101010111110111110111110111110111111111110111011111111101111111
1000100000101000100000100010000010100010001000000010001000001000100010001
1011111111101111101011101011111011101011101110111011101111101110111010101
1010001000100010001010001000001000001000100010001000100000100010001010101
1010101010111010101110111110101111111110101011101110111110111010101010101
1000100010000010100010100010101000001010101010001010001000100010100010101
1111101110101110111000101011101011101010111010111011101011101110111110101
1000100010101000001000101000101000100010000010000010101010000010001000101
1010111110101111101111101110101010111010111111111010101010110011100011101
1010001000100000101000001010001010001010000000000010100010100010001010001
1011101000110110111011011011111011101011101010111110111110101110111010111
1010000010000010100010000000001000101000001000000000100000101010000010001
1010111111111110101110101111101110101110101111111010101111101010101111101
1000000000000000001010100000101000100010001000001010000010101010001000101
1011111111111101101010111110111011111011101011101010111010101011111010101
1010001000100000001010000010000010001010000000000000100010100000000010101
1011101010101110101011111011101011101010101111101110101110101010111111101
1000100010100000101000001000100010001010000010000010001000001010000000001
1110101110101111101010101110111110101011111010101010101010101011111111111
1010100000101000001010001000100010101010000000101000101010001000100010001
1010111010101001111110101011101010101011111111101011101010111110100010101
1010000010001000000010101000001000101000000010001000100000001000001010101
1011111011111110011010111110101111101111111011101110111011101011111011101
1000001000000010001010000010100000100010001000100010100010101010001000001
1010101111111011101010111010111110101010101110111110101110101110101111101
1000100010001000101010100010001000101010101000100000100010100000001000101
1110111010101110101010101011101011101011101011101111111010111110101110101
1010101010100000101010101000101010000000001000101000100010100010100010001
1010101010111111100011101111101011111111101110100010101010101011111011101
1010101010000010001000100000001000100000100010100010100000101000000000101
1010101011111010111110111111101110101110111110111110101111101111101110111
1010101000100010000010100000101000100010000000001010101000001000100010001
1010101110101111111010001010101010111011111111101010111011111010111010101
1010101000100000001010000010100010001000001000000010000010001010001010101
1010001010111111101111111010100111111101101111111011111110101011101011101
1000101010001000101000100010100000000000100000100010001000101010100010001
1011101011101011101010111010101111111110111110101110101010101010111110101
1000101010101000100010001010100000101000100010100000001000101000000010101
1110101010101010101111101110101110101011101010111111101110101111111010101
1010001010001010000000100000101010100010001000100000100000100000100010101
1010101010111011111110111111101010111011101111101110111011111011101110101
1000100010001000001000100000001010001010001010001010000010001000001000101
1011100111101111111011101101111011101010111010111011111110101011111011101
1000100000001000001000000000000010001000100000100010000010100000000010001
1010111110101011101111111111111110111111100111101011101010111110101111101
1000001000100010001000000000000000100010100000001000001010001000100000101
1011111011111110111011111111111111101010111111011111111011101011111110111
1010000010000010100000000010000000000000000000001000000010001000100010001
1010111111110000111011111010111111101111111111111011111110111011101011101
1010001000000010000010001010000000100000100000001000100010100010001000001
1011101010111111111010101011111110101010101111101110101010101110111111111
1000001000001000000000100010000000101010100000100010101010101010000000001
1110101111101011111110111111111011101010111110111010101010101011111011101
1010101000100000100010100000001000100010100000101000101000100010001000101
1010101010111011101011101111101111111010101111101111101111111010101100101
1000100010001010001010001000100000001010000010000010001000001010100000101
1011111111101110111010111110111111101011111011111010111011100010111110101
1000100000100000100000100000100010001010001000000010000010001010100000101
1110111010111111101111101110101010111110101111111111011110111110111011101
1010000010100000001000001000101010100010000000000010000000100010001000101
1011111110101111101111101011101010100010110111111000001011101011101110101
1000000000001000000000001000001010001000000000001000100000001000001000000
1111111111111111111111111111111111111111111111111111111111111111111111111
