1111111111111111111111111111111111111111111111111111111111111111111111111
0000100000000000100000100000001000000000000000000000000000001000000000001
1110101111101110111011101011101011111111111111111111111010101011101111101
1010001000100010100010001000101000100000100000001000100010101010101000001
1011111010101110101010111110101010101110101111101011101110101010101110111
1000000010001000101010101000101010000010100000101000100010100000100010101
1010111111111010101110101011101111111110101111101010111010111111111000001
1000000000001010000010101010000000000000101000001010001010000000000010001
1011111110100010111010101011111111111110101011111011100011111110101111101
1010000010001010100010001000000000100010101010100000101010001000101000101
1110111010111010101110101111111110101000101000101111101010001011101010001
1000101010100010100000000010000010101000101000100010001000100010100010101
1011101010101111101011111011111010111011101010111010111111111110101110101
1010000000100000101010001000001000001000101010000010100000000000100010001
1010101011111110101010101111101011101111101011111110101011111110111011111
1010100010001000101010100000100000100000001000001000101010000010001000001
1010111010101011101010100110111110101111111110101011101010111011111111101
1000001010100010001000100010000010100010000000101010001000101000100000101
1111101010111110111111111011101110101010111011101010111101101110101110101
1000001010000010100010000010001000101010001010001010100000001000101010001
1011111011111011101010111111101011101111101010111010111110101011101011111
1000001010001000101000100000101000100000101000100000100000001000001000001
1010101011101110101110101110111110111100101111111011101111101111111011111
1010101000000010000010101010000010001000100000001000101000000000001000001
1110101111111010111011101011111011101010111011101110101111101111100011101
1000100010001010001000000000101000101000000010001010100000001000001000101
1011101110101011101011111110101010101110101110111010101111101110111110101
1010000000101010101000100010001010100000101000000010000000100010100000101
1011111011101000101111101011111011111011111010101011111110101010101110101
1010001010001010100000001000001000000010000000101000001000101010100000101
1010101110111010111111011111101111111110101110101111111011101010111110101
1000101000100010000010000000000000000010100000100000000010001010000010101
1011101010101111100010111011111111111010111111101111111111111011101010101
1000001010101000001010001000000000001000100000101000000000100010000010101
1010111011101011111011101111111111101111101111101010111010101111111011101
1010100000000010100010001000001000000010000000001010100010100000001000101
1010111111111110101110111011100011111010111111111110101010111011101110101
1000001000001000100010100000101010000010000010000010001010000010101010101
1011101011101110111010101110101011111111101000101011111011100010101010101
1010001000100010100010001000001000100000101000101000000010101000001010101
1010101110111010101111111011111110101110101001101111111110101110101010101
1010100000100010101000001010000010001010001000101000101000000010100000001
1010111010101110101110101010111011111011111110101010101011111011101111111
1010000000101000101000101000100010100000000010100010100010001000001000001
1011111111101010101011111111101110101111101011111110101110101110111011101
1000001000100010000010000000001000100010001000000010101000100010000010101
1110111010101011111110111010111011101010111111111010111011111011101010101
1000100010001000100000101000101000100010000000000010100010001000001000101
1011101110111111101101101111101010101110101111111110100111101011111011101
1010100010100010001000000010100000001000101000001000000000000010000010001
1010111011101010111011111010101111111011101010101111111011111011100010101
1010001010001000100010001010001000000010101010100000100010001000001010101
1010101010101111101111101010111011011110101000111110111110101111111010101
1010101000100010001000001010100010000000100010000010000000101000100010101
1010101111101110101010111010101111111000111110101111111101101010101110111
1000101000000000101010000010100000001010000000100000000000100010101010001
1111101110111111100011111011111011101111101111111110111110111110101011101
1000100010000010001000100000001000101000101000000010100000100010100010001
1011111010111110011110111110101110001010101010111010101111100010101110101
1000001010100010000010000000101000100010101010001010100010001000101000101
1110101011101011101011111111101011111110101111101010111110111111111011101
1000101000001000101000101000101010001000000000001010000000100000000010001
1011111101111110111110101010101010101011111011101110101111111110111110111
1000100000000010001000101010001000101000100000101000001000000010001000101
1010101110111111101011101011101111101110101011101010101011111011101011101
1010000010000000100010100010000000000010101000101000100010100010001010001
1011111111111110111110101110111111111110101110101110111110101110111011101
1010000000000000000000100010000010001000100010100010000010001000001000001
1010101111111110111111111011101110101011111010111011101110111110101011101
1010101000001000100000001010001000101000101010100010100010100000100010001
1010101011101111101111101011011010101110101010101110111010101111101110111
1010000000100000000000100000000010000000100010000000001000001000000000000
1111111111111111111111111111111111111111111111111111111111111111111111111
