1111111111111111111111111111111111111111111111111111111111111111111111111
0000101000000000001000001000100010000000001000001000000000001000000000101
1110101010111111101000100010101110111111101010101010111111101011111010101
1000100010000000100000100010001000000000100010100010100010001010000010001
1011101111111010101110111111111011111111111110111010101010101110111111101
1010001000000010000010000000000000100000100000101000100010000010100000001
1010111111101011011011111111111110101110101111101111101111011010111111101
1010000000001000001000000000000000001010001000100010000000000000100000101
1011111111101101101111111111101101111011101011101010111111111110101110111
1000100000101000101000000010001000100000000000001010100000100000100010001
1110111010101110101110111110111010110111101111111010101110101110111011101
1010100010101000100010000000100010000000100010100010101000100010001010001
1010101111101000111011111110101111111110111010101110101010111010101010101
1010100000101010001000100010101000000010100010100000101010000010101010101
1010111110101011101110101011101011111010101010111011101010101110101010111
1010000010101010000010101000100010001010100010001000001000101000100010001
1011111010101011111010101110111110111000101110111011101111111011111111101
1000100010001000100010001000000010100010101000000000100000000010000000101
1011101110111110101111101011111010101110101011111111111011111111111110101
1010001000100010101000101010000000101000101010001000001000001000100000101
1010111011101010111010101011111111101011101000101011101111101010101111101
1010001000001000100010101000000010001010101000101010001000000010101000001
1011101011011110101110101111111010111010101101111010111111111110101011111
1000100000001000100010100010100010101010000000000010100000100000001000001
1011101101101111111010111010101110101011110011111110101110111110111111101
1010000000100000000000001010100000101000000000000000101010000010100000101
1010111011110111111111101010111111101100111110101110101011111011101110101
1000101000000010000000101010000010000000000010101000001000100010001010001
1001101110111010111111101011101011111010111110100011101010101110111011101
1000000010101010001000001000101000100010100010101010001010001000100010001
1110111110101011101011111110101110001011101010101110111110111011101010111
1000100000101000001000100010100010001010001000100010000010001000100000001
1101101111101111101110101010100011111010111110111011111011101010111111101
1000101000000010000010101010101010000010100000001000000010001010000000101
1000101011111010111110101000111011111000101111111111111110111111111110111
1010001000001000001000101010100010001010101000000010000010001000000010001
1011111011111111111011101110101110101110101011111010101011101011111011101
1000001010000000000010000010100010100010101000100010101010001010000000001
1011101110011111111110111010111010111010101110101010101110111011111111111
1000100010000010100010001010001010001000100010101000100000100000000000001
1110111011111010001011100011101011101111100010101011111111101111111111101
1000101000000000001000000000000010001000100000101000100000100000000010001
1011101111111111101111111111111010101000101011101110111010110111111110101
1000000000100000101000100010001010100010001010000010000010100000100010101
1111011110111010101010101010101010111110101010111111111110101110101010111
1000000010001010100010101000101010000010101010100000000010101010001010001
1110111011101010101111101111101011111010101010101010110110101011111011101
1000000010100010101000001000101010000010001010001000100010001000001000101
1011101110111110111011111011101110111110011011011010101011111111101110101
1000100000100010100010000010001000100000000000001000101010000000001000101
1010111110101010101110101110111011110111111111101110101010111011101011101
1010000010001010001010100000101000000000100000100010001010101000101010001
1011111011111011111010111111101011111110101110111011111010101110101010101
1000101000001010000010000000101010000010101000001000001000001000101010101
1110101111101010111011011110101011101110101110111011111110111011101011101
1010100000101010100000000010101000001000100010100010000010100010001000001
1010101101101010111111111010101111101011111011101110111010101110111111101
1010101000001010000010001010100010001010000000001010100010001010100000101
1010101011111011111010101010101110111011101010111010101110111010101011101
1000001010001000001010100010100000100010001010000010100000101000101000001
1011111010111111101011111110000111101110011111111010100111101011101111111
1010001010000000001010000000100000001000000000100010000010001000101000001
1010101010111111111010101111110111101011111110101111111000111110101011101
1010100010100000100010000000000000101010000010001010000010000000100010001
1010111110111010101111101111101110100011111011111010111110111111111110111
1010000000001010001000001000001010101000000000000010001000000000100010101
1011111011101011111011111011111010101111110110101011101011111110101010101
1010001010000010001000000010000000101000000010101000101010000010001010101
1011101011111110101111111110111111101111101010111011100010111011111110001
1010001010000010101000000010000000100000100000100010001010001000000000101
1010101010111010101011111011101110111110001110101010111111101111111111101
1000101000000000100000001000000000000000100000001010000000000000000000000
1111111111111111111111111111111111111111111111111111111111111111111111111
