1111111111111111111111111111111111111111111111111111111111111111111111111
0010000010100000000000001010000010000010001000001000001000001000100000001
1011101010101111101110101010101010111011101010101011101110101110101111101
1000001010000000101000101000101000101000100000101000100010100010001000001
1111111011111111101010101100101111101110111110101010111010111010011011101
1000001010000010001000100000101010000000100000101010101000000010001000101
1011101010111010111011111110101010111111101111101110101111101011101110101
1010001000100010001000000010001000100000001000001000100000001010001000101
1110111101101111101011111011011011111011111011111011111110101010111011101
1000100000100010001010000010001000000010001000100010000000101010100010101
1011101110110010111000111011101111111110111110101111101111111010101110101
1000001000100010100010101010000000000000000000100000000000000010101000001
1011111011101110111110101010111111101011111010101110101111111111101111111
1000101000001000000010100000100000101000100010000000100000100000001000001
1110101111111011111010111110101110101110001111111111111110101111111011101
1010101000001010001010001010100010000000100000001000000010101000100010101
1010101010101010101010101010101010111110111011111011101110101010101110101
1000101010101010100010101000100010000010001000001000100000100010100000101
1011100010111010111110101111101111101011001111101110101111101110111110101
1000100010000010100000101000100000000010001000101000100000101010001000101
1110101111111110111111101010111010111110111010101011111110101011101011101
1000100010100000100000001010000010100000100010001000000010000000100010001
1011111010101111101110101011111110101111101111101111111011111111111110101
1010000000101000100000001000100010000000100000100000101000100000000010101
1010111111101010111010111110101111111110111110111010101110101111111010101
1010100000001010001000100010001000001000000000001010001000101000001000101
1010101111111011101110101010111011101111111110111010111011101110111110101
1010100010000000100010101000100010000010000000100010100010001000100000101
1011111010111110111010101111101111111011101111101110101110111011101011101
1000000010100000101010100010100000001000100000001010101000100000001010001
1111110111101111101010111010111111101110101011111010001110111110111010111
1000000000001000001000001010000000100000101010000000100010100010001010001
1011111011101011111011111010111111101110111011111111111010101011101011101
1000001010001000000010001010000000100010000010000000001010001010001010001
1011101010101111111110101010111110111011111110101010111010111010111000111
1010101010100000000000001010000000001000000010100010100010101010001010001
1010001110111111111111101011111011101111111010111110101110001011111011101
1010100000100000100010001010001010000010001010100010101000001010001000101
1010111111101000111010101010001010111000101010101000101111111010101110101
1000100000000010100010101010100010001010100010001010100000001000100010001
1110111011111110101110101011111110100010111011101010111111101110111010111
1010001000001000001000101000000010101000101000001010000000100010100000001
1011101111101011111011111111111011101010101111101011111010111010101011101
1000100000001010001000000000100010001010101000001000101010100010001000101
1110111111111010101111111110101110101110101011111110101011101110111010101
1000100000100010100000000000100000101000100000100010101000001000100010101
1011101110101110111111111110111111100011101111101010101111011010111011101
1000101000000010000010000000000000101000101000001000100000001010001000101
1010101011111011111011100111111111101110111011111111101011101111101110101
1010001010000000001000000010000000001010001000000000001010100000100010001
1011111010111110101011111010111010111011101111101011101010111110111010111
1010000010000000101000101000100000000010000000100000101010100010001000001
1110101111111111101010101111101011111010111110111110111010101011101110101
1000101000001000100010000000101000000010100000100000100010001000100000001
1011101010111010111111111010111011101010111111101111101111111011111111101
1000101010100000000000000010001010100010001000001000001000001000001000101
1010111010101111111011111111101010101011101010111011101011101011101010101
1010000010001000100010000000100010000010101010000010001010101000101010001
1011111111111011101010111100111110111110101010111111111010101110101011011
1010000010000010001010101000000010001000100010000000100010101000100000001
1011101011111010111010101011111011101110111111111110101110101111111111101
1000001010000000100010000000001000100000000010000010100000101000000010001
1111111010101110111111101111101110111011101010111010111010101011111010111
1000001010101000100000100000101000001010001000101010001000100000000010001
1010111010111011101010111110101111111010111111101000101011111111111011101
1010000010000010001010000010100000000000000010000010101000100010000010001
1011111111101010111010111010111010111111101011111010101100101010111110111
1010000010001000100010000000101000100000101000000010100000101000100010101
1010111010101111101011111111101011101110111111101011101111101111111010101
1000100000100010001010001000001000100010001000000000101000101000000010101
1011101110111010111010101100101010111011101011111110111010101011111110101
1000000000100000100000100000100000000010000010000000000010001000000000000
1111111111111111111111111111111111111111111111111111111111111111111111111
