111111111111111111111
001000100000000000101
101010111011111110101
101010001000001010001
101011101111101011101
101000100000001010001
101110101111111010111
100010101000100010101
111010111010101110101
100010000010100010001
101110111110111011101
100010100000100010001
111011101111101010111
101010001000001010101
101010111010111110101
101010101010000000101
101010101011111111101
101010101000001000001
101010101111101011101
100000100000000010000
111111111111111111111
