111111111111111111111
000000100000001000001
111110111011101010101
100010001000100010101
101111101111111110111
100000101000100010001
101110101010101011101
100010001010001000001
111011111011111111101
100010100010001000001
101110101010101110111
100010001000100010101
111010111111111010101
100010001010000010001
101111101010111111101
100000100010000000101
111110111111111010101
100000100000001010101
101111101111101110101
100000001000000000100
111111111111111111111
