111111111111111111111
001000001000000000101
101011101011111010101
101000101000001010001
101010101111101011101
101010100000101000101
101110111110111010111
100010000010001010001
111010111011101011101
100010001010101010101
101110111010101010101
101000100010001000101
101011101110111111101
101010001000100000001
101110111011101111101
101000101010001010001
101011101010111010111
101010100010100010001
101010101110101011101
100010000000101000000
111111111111111111111
