111111111111111111111
000010100000000000101
111010101111101110101
100010000000101010101
101110111111101010101
101000100000001010001
101110101111111011101
100010100010000000101
111011111011111010101
101010001000100010101
101010101110101110101
101000100000100010101
101111111111111011101
100010000000000010001
101010111011111110111
101000100010000000101
101111101010111111101
100010101010100000101
111010101110101110101
100000100000001000000
111111111111111111111
