111111111111111111111
001000000000000000001
101011101111111111101
101000100000001000001
101110111111101011111
100010000010101010001
111011111010101110101
101000100000100000101
101110111110111111101
100010001000100010001
101111101110111010111
100000100010001010001
101110111011101011101
100010100010001010001
111110101111101010101
100000101000100010101
101111101010111010101
100000001010001010101
101111111011101110101
100000000010000000100
111111111111111111111
