111111111111111111111
000010000000001000001
111010111111101111101
100010001000101000001
101111101110101011101
100000001000100010101
111111111010111110101
101000000010000000101
101011101111111110101
101010100000100010101
101010111110101010101
100010001000101010101
101110111011101110101
100000100010000000101
111110101111101111101
100010100000101000001
101110111110101011111
100010100000101000101
101010101111111110101
101000100000000000000
111111111111111111111
