111111111111111111111
001000000010001000001
101110101010101011101
100010101010100010001
111011101010111110111
101000001000100010101
101111111111101110101
100000100000000000101
101111101111111111101
100000001010000000001
101111111010111011101
101000101000101010001
101010101011101011101
100010100000101000101
111110111110101110111
100010001000100010001
101011101110101111101
101000100010001000001
101011111011111011101
101000000000000010000
111111111111111111111
