111111111111111111111
000010100000000010001
111010101110111010101
100010000010101000101
101111111110101111101
100000000000100010001
111111111111101010111
100010000010001010001
101110111010111011101
100000100010100010001
101111101110101010111
100010001000101010001
101110101011101111101
101000101010101000001
111011101010101011111
100010001000100010001
101111101110111110101
100000100010100000101
101110111110111110101
100010000000000000100
111111111111111111111
