111111111111111111111
000000100000100000001
111110101011101110101
100000101010000010101
101111101110111110111
100000101000100010001
111110101011101011101
101000100010001000001
101011101110111111101
100010100010001000101
101110111011101010101
101000100000101010101
101110101111101011101
100010001000001010001
111010111011111010111
100010100010000010101
101110101110111010101
101000100010101000101
101111111010101111101
100000000010000000000
111111111111111111111
