111111111111111111111
000010000010000000101
111011101011101110101
101000001000001000101
101111111111111011101
101000001000100010001
101010111010101110111
101010000010001000001
101011111111111111101
101010000000001000001
101011101111101011101
101000001000001000101
101111111011111010101
100010001000100010101
101110101110101110101
100000100010101000101
101111101010111011101
101000101010000010101
101010101111111110101
100010100000000000000
111111111111111111111
