111111111111111111111
001000000010001000001
101110111010101111101
100010101000100000101
111010101111111110101
101010100000000010101
101010101111111010101
101010101010000010001
101010101010111111101
101010100010001000001
101010111011101011111
101000101000101010001
101111101011101011101
100000100010001000101
101111101110111110101
101000001000100010101
101011111011101010101
101000100010001010101
101110101110111010101
100000100000001000000
111111111111111111111
