111111111111111111111
000000000010000000001
111111111010111011101
100000100010100010001
101110101111101110111
101000101000001010101
101011101110111010101
101000100010101000101
101110111010101011101
101000001000101010001
101011111111101011101
101010000010001010001
101110101011101010101
101000101000001000101
101011101110111111101
101010001000100000001
101010111110101111111
100010100010101000001
101110101011101011101
100010001000000010000
111111111111111111111
