111111111111111111111
001000001000000000001
101011101111101111111
101000101000001000001
101110101011111011101
100000101000000010001
111111101110111110111
100000100010000010001
101111111011101111101
100000001000101000101
101111101110111010101
101000100010000010001
101010101111111111101
101010100010000000101
101110111010101111101
100010100010101000101
111010101010101010101
100010101010100010001
101110101110111111111
100000100000000000000
111111111111111111111
