111111111111111111111
001000001000000000001
101111101011101111101
100000101010101000101
111110101010101010111
100010100000100010001
111010111111111110101
100010001000100010101
101111101010101011101
100000101010001000001
101110101011111111101
101010001000100000101
101011111110101111101
100010000010100000001
111010101010101111111
100010101000100000001
101110101111111111101
101000101000000000101
101111101011111011101
100000001000001000000
111111111111111111111
