111111111111111111111
000000100000000000001
111110111110111111101
100010000010001000001
101011111011101011111
101000001010001000001
101111111010111111101
100010001010000000101
101010101010111110111
101000101010000010001
101111101011111111101
100000100010000000001
111110111110111111101
101000100000100010001
101011101111111010111
101010001000000010101
101010111110111110101
100010000010000010101
101111111010111010101
100000000010001000000
111111111111111111111
