111111111111111111111
000010001000000000101
111010101011111110101
100010101010000000001
101110101011111111101
100000101000000010001
111111101111101010111
100000101000101010001
111010101010111011101
100010100010001010101
101110111111101010101
100010100000100010001
101011101110111110111
101010001010000010101
101010111010111010101
101000100010001010001
101111111011101111101
100010001000100010001
111010101110111010111
100000100000001000000
111111111111111111111
