111111111111111111111
000000100000100000001
111110111110101111101
100010000010101000001
101011111010101011101
101010000010101010001
101010111110101011101
101010001000101000101
101011101011101110101
101000001000001010101
101111111011111010111
100000100010000010001
111110101111111011101
101000100000000010001
101011111111101110101
101000000010001000101
101111111011111011101
100000100010000010101
101011101110111110101
101000000000100000000
111111111111111111111
