111111111111111111111
001000000000100000001
101011101110111011101
101010001000000010001
101110111011111110111
100010001000100010001
111011101011101011101
101010001010001000101
101010111110111110111
100010000010100010001
101110111010111011101
101000100010100000101
101110101110101111101
100010101000100000101
111010101011111110101
101010100000000000101
101011111111111011101
101010000010001010001
101010111010101110101
100000100000100000100
111111111111111111111
