111111111111111111111
001000100000001000001
101010101111101011101
101010100010101000101
101010111010101111101
101010100010101000001
101010101110101011101
100010100010100010101
111110101010111110101
100000101010000010001
101111111010111010111
101000000010001010001
101011111110111011101
101000001010100010001
101111101010101110111
101000001000100000101
101011111011111111101
100010001000000010001
111110111111111011101
100000000000000000000
111111111111111111111
