111111111111111111111
001010000000100000001
101010111011101110101
101000101000100010101
101110101110111010111
100010100010000010001
111010111011111110101
100010000010000010101
101111111110111011101
100000000000100010001
111111111111101110111
101000001000101010001
101010101010101010101
101010100010101000101
101010111111101111101
101010000000100000101
101011111110111110101
101010000010001000101
101010111010111011101
100000100010000000000
111111111111111111111
