111111111111111111111
000010000010000000001
111010101011111010101
101010101010001010101
101011101010101110101
100010001010100000101
101110111010111111101
100000100010000000101
111111101111101110111
100000100000100010001
101111111110111011101
101000100010001010001
101010101011101010111
100010001000001010001
101111111111111111101
100000101000000010001
111110101011101010111
100000100010001010001
101111111110111011101
100000000000100000000
111111111111111111111
