111111111111111111111
000010000000000010001
111010111110111010111
101010000010100010001
101011111010111011101
101010000010001000101
101011101111101110101
101000101000101000101
101110101010101110101
101000101010100010001
101011111010111011101
100010001010001000101
101110101011101010101
101000100010101010101
101011111110101110101
101010001000001000101
101010111011111011111
100010001000001000001
111110101111101111101
100000100000000000000
111111111111111111111
