111111111111111111111
000000100010000010001
111110101010101110101
100010101010100010101
101010101010111010101
101010101000001000101
101010111111111110101
101010100000000010101
101110101111111010101
100010001000001010101
101011111111101011101
101000000010001000001
111110111010101111101
100000101010101000101
101111101010111010101
100010000000100010101
111010111110101110101
100010100010101000101
101111101011101011101
100000001000001000000
111111111111111111111
