111111111111111111111
001000001000000000001
101110111010111111111
100010000010000010001
111010111111101010101
101010100000101000101
101010101110101111101
100010101010101010001
101110101010101010111
101000101000100010001
101111101011111111101
100000101000100000101
111110101110101110101
101000101010100010101
101011101010101010101
101010001000101010101
101010101110101010101
100010100010101010101
101111111010111010101
100000000010000010000
111111111111111111111
