111111111111111111111
001000001000000000001
101010101110111111101
101010101000100000101
101010101011111110101
101010100010000000101
101010111111101110101
101010100000101000101
101110101110101111101
101000101000001000101
101011101111111010101
100010001000000010101
111111101011111110101
100000001000100010001
101111111110101111111
100000001000100000001
101111101011101111101
101000101000100000101
101010101110111111101
100010100000000000000
111111111111111111111
