111111111111111111111
001000101000000000001
101010101010111111101
100010101010001000001
111110101011101011111
100010100010001000001
101110101110111111111
101000100010000010001
101011111011111010101
100010001010001000101
101111101011101111101
100000101000100010101
111110101110101010101
100000100010001000101
101111101011101111101
101000001000001000001
101011111111101011101
101000001000101010101
101111111010111010101
100000000010000010000
111111111111111111111
