111111111111111111111
000010000000000000101
111010111111111110101
101010100010000010101
101010101010101110101
100010101000100000001
101110111011111111111
101000001010001000001
101011101110101011101
101010100000100000101
101010111111101111101
101010001000101000101
101011101010111010101
101000101010000010001
101110101011111111101
100010001000001000101
111011111011101110101
101010001000100010101
101010101111111010101
100000100000000010000
111111111111111111111
