111111111111111111111
000000001000001000001
111111101010101110101
101000101010100000101
101010101010111111101
100010101010100000001
101110101110111110111
101010100010100010001
101010111010101011111
101010001010001010001
101010111010111010101
100010100010001000101
111010101111111110101
100010001000000010101
101111111011111011101
101000000010001000001
101011111111101111101
101000000010000000101
101111111010111111101
100000000010000000000
111111111111111111111
