111111111111111111111
001000100000001000001
101010101110111011101
100010101010000010001
111110101011111110101
101000100000000010101
101011111111111010111
101010000000001010001
101010111111101011101
101000100000001010101
101111101111111010101
101000001000001000101
101011111010101111101
100010001010100000001
101110101110111111101
101000101000100010001
101011101011101010111
101010101010001010101
101010101010111010101
100010000010001000000
111111111111111111111
