111111111111111111111
001000000010100000001
101011111010101011101
100010001010001010001
111110111010111011101
100010000010001000101
101010111111101110111
101010100000000010001
101110111111111111101
100010000000001000001
101011111111101011101
101000000010001010001
101011111110111010111
101000100000100010001
111110101111101111101
100010100010100000101
101010111010101110101
101000100010001000101
101111101111111011101
100000000000000010000
111111111111111111111
