111111111111111111111
000010100000000000001
111010101111101111101
100010001000001000001
101111111011101111111
100000001000101000001
111111101010111011101
101000101010000010001
101010101111111110111
100010100000000010001
101110111111111011101
100010000000001000001
111011111011111111101
101000001010000000101
101111101010101011101
100000101000101010001
101110101111101110111
100010101000100010001
101011101110111011101
101000000000001000000
111111111111111111111
