111111111111111111111
000000100000000000001
111110101111111110101
100000100010000010101
101111111010111011101
100010001010100000001
111011101010111111101
101000100010001000001
101110111110101111101
100010000010100000101
101111111011111110101
100000100010000010101
111010101110111010111
100010100000100010001
101111111111101111101
100000000000101000001
101110111111101011101
101000100010001000101
101011101010111110101
101000001000000000100
111111111111111111111
