111111111111111111111
000000100000001000001
111110101110111010101
100010100010001010101
101010111111101010111
101010001000100010001
101011101010111111101
101010101010100010001
101010101010101010101
101000101010101000101
101110101010101111101
100010100010100010001
111010111110111011111
100010000010001000001
101110111111101011101
101000100000101000101
101011101110101111101
101010001010100000101
101110111010111110101
100000000010000000000
111111111111111111111
