111111111111111111111
000010100000000010001
111010101111101010101
101010001000001000101
101011111011111111101
101010000010000000101
101010111111101110101
101010001000100010001
101010101010111111111
100010101010000000001
101111101011111110101
100010001000100010101
111010111110101011101
101010100010101000101
101010101010101110101
100010101000101010001
101110101111101011101
100010001000101000001
111011111010101011111
100000000010001000000
111111111111111111111
