111111111111111111111
001000000010001000001
101110111010101111101
100010100010100010001
111010101110111010111
101000100000100010001
101111111111101110101
101000000000100010101
101011101110111011101
101000100010001000101
101011111011101110101
101010000010101010101
101010111110101010101
100010001010001010001
101111101010111011101
100010001000001010001
111010101111101010111
100010101000100010001
101110111010111111101
100010000010000000000
111111111111111111111
