111111111111111111111
001000001000000000001
101110111011111011111
100010001000001000001
111011101111101111101
101010000010000000101
101010101110111111101
100010101000100000001
101110111011101111101
101000100000101000101
101010101111101011101
101010101010001000001
101110101010111011111
100010100010101010001
111010101110101010111
101010001000101010001
101011101011101010101
101000101000101010101
101110111110101011101
100000000000100000000
111111111111111111111
