111111111111111111111
000010001000000000101
111010101011111010101
101010100010000010101
101011111110111110101
101000000010001000001
101111111010101111101
101000100010100000101
101010101110111110111
101010100010000010001
101010111011111111101
100010001010001000001
101110111010101011101
100010000010100010001
111011111110111110111
101010000000001000101
101011111110101110101
101010000010100010001
101010111011111011101
100000100000000010000
111111111111111111111
