111111111111111111111
000010000000100000001
111010111110111011101
101010100010001010101
101010111011101010101
100010001000001010001
101110101110111010111
100010100010100010001
111011111010101111101
101000100010100010001
101110101110101011111
101000101000101000001
101011101110111111101
101010000010100000101
101011111010101110101
101000000010101000001
101111111110101111101
100010000010100000101
101110101110111110101
100000100000000000100
111111111111111111111
