111111111111111111111
001000000010000010001
101110111011111010101
100010001000001000101
111011101111101111101
101000001000100000001
101111111010111111101
100000000010100000101
101111111111101011101
100000001000001010001
101111101011111010111
101000101000101000101
111010101110101111101
100010001000101000001
101111101011101010111
101000001000100010001
101111111110101111101
100010000010101000101
101010101110111010101
101000100000000010000
111111111111111111111
