111111111111111111111
001000001000000000001
101011101111101111101
100010101000100010101
111110101010111010101
100010001010001010001
101110111011101011101
101000100010001000101
101011111010111110101
100010000010001000101
101110111111101011111
100010100000101000001
111010111010101111101
101010001010001000101
101010101011111010101
101010101000100010001
101011101110101011101
101010001010101010101
101010111010111010101
100000100000000010000
111111111111111111111
