111111111111111111111
000000100000001000001
111110101110111011101
100010100010000010001
101010111111111010111
101010000000001010001
101111111111101011101
101000000010001010001
101010111110111110101
101010001000100010101
101011101011101010111
100010001010001010001
101110111010111010101
101010100010100010101
101010101110111011101
101010101000001010001
101010101011101010101
101010101010001010101
101010101110111010101
100010000000100000100
111111111111111111111
