111111111111111111111
000000100000000010001
111110101110111011101
100010100010101000101
101010111010101110101
101010001010100000101
101111101110101111101
100000101000101000001
101110101011101111101
100010100010001000001
101110111110111011101
101000001010100010101
101011101010101010101
101010000010101010101
111010111110101010101
100010100000101010001
101011101111111010111
101010001000000010101
101110111011111110101
100000000010000000000
111111111111111111111
