111111111111111111111
001000000010000000101
101111101010101110101
100000101000101010101
111110101111101010101
100010100010001010101
101010111010111010101
101010101010100000101
101110101010111110101
101000101010000010101
101011101011111010101
100010001000001010001
101111101011111011111
100000100010001000001
111110111110101111101
100010100000100000001
101110101111111111101
101000101010001000101
101011101010101010101
100000001000100010000
111111111111111111111
