111111111111111111111
000000001000000000101
111111101110111110101
100000100010001000101
101110111011101011101
100010001000001000101
111010101111111110101
101010100010000010101
101010111110111010101
101010001000101000101
101011101011101111101
100010001010100000001
111110111010101110101
100010001010001000101
101011101011111011101
101000101000001010101
101110101111101010101
100010001000100010001
101011111010111110111
101000000010000000000
111111111111111111111
