111111111111111111111
000010000010000010001
111010111010111010101
101010100010101010101
101010111110101010101
101010000010101000101
101010111010101111101
101010001010001000101
101011101011101010101
101010101000001010001
101010101111111011101
100010100000101000101
101110111110101110101
101010000000000010101
101010111111111010111
101000100010001010001
101111101010101110101
100010001000100010101
111010111111111011101
100000100000000000000
111111111111111111111
