111111111111111111111
001000000000100000001
101110111110111011101
100000100010001010001
111111111011101010111
100000001010001010001
111110101010111111101
100000100010000000101
101111111111111110101
101000000000001000101
101011111111101011101
100010100010001000101
101110101010101110101
100010101000100010001
111010101111111111101
100010100000100000001
101110111110101111111
101000000010101000101
101011111010101010101
100010000010000010000
111111111111111111111
