111111111111111111111
000010000000100000001
111010111110111111101
100010000010000000001
101110111011111111101
101000001010001000001
101110111010111011111
100010100010000010001
111010101110111110101
100010101000100000101
101110101011111011101
100010101010000010101
111010101010111110101
101010101000100000101
101010101111101110101
101010100010001010101
101011111010101010101
101000001010101000101
101111101010101111101
100000000010100000000
111111111111111111111
