111111111111111111111
000000100000000000001
111110101111111111101
100010100000100000001
101010111111101111101
101010000000001000001
101011111111111011111
101000001000101000001
111011101010101111101
100010001010000000101
101111101011111111101
100000101010000000101
101110101010111110101
101010100010001010001
101010111011101011111
100010001000100010001
111011101111111010101
100010100010001010101
101110111010101010101
100000001000100000100
111111111111111111111
