111111111111111111111
000010000010000000001
111010101010111111101
100010101010100000101
101110101010111011101
101000101010000010001
101011101011111110111
101010001000000010001
101110111111111010101
100010100000001010101
111010111011101011101
101010001010100010001
101011101010111110101
101000001000100010101
101111111110101010101
100000001000101000101
101111101011101111111
101000101010000000001
101110101011111111101
100000100000000000000
111111111111111111111
