111111111111111111111
000000001000000010001
111111101110111010101
100000100000100010101
101110111111101110101
101000101000100000101
101110101010111111101
100010001010000000001
101011111011111111111
101000000010000000001
101111111111101111101
101000000000100000101
101111111010111010111
100010001010001010001
111010101011101011101
101000101000101010001
101111101010101110101
100010001010101000101
101110111110101011101
100000000000100010000
111111111111111111111
