111111111111111111111
001000100010000000101
101010101010111010101
101010001000001010001
101110111111111011101
100010100000000010101
111011101111111110101
101010001010000000101
101010111010111110101
101000100010000010001
101111111011111011111
100000000010001010001
101011111010111011101
101010001010001000001
101110101011101111101
100000101000001000101
101111101111111010101
100010100000100010001
111010111110101111111
100000000010000000000
111111111111111111111
