111111111111111111111
000000000000000010001
111111111111111011101
100000100000001000001
101110101011101111101
101000101010101000001
101011111010101011111
101000000010001010001
101111111011111011101
100000001010001000001
101111101010101111101
100000101010100000101
101111101110101111101
101000001000100010001
111011101011111010111
100010001000001010001
101111111110111011101
100010000010100000101
101010101110101111101
101000100000100000000
111111111111111111111
