111111111111111111111
001000000000001000001
101111101111101010101
100010001010001010101
111010111010111110101
100010001000000000101
101110101111111111101
101000100000100000001
101011111110101111111
101000101000101000001
101110101011101011111
101000101010101000001
101011101010101111101
101000001010001000001
101111111010111011101
100000100010100000101
111110101110101110101
100010101000101000101
101110101011111011101
100000001000000010000
111111111111111111111
