111111111111111111111
000000100000100010001
111110101010101010101
100010101010001010101
111010111011111011101
100010001000001000101
101011101011101110101
101010001010100010001
101110111010111011111
101000100010001000001
101011101111101111101
101000101000000000101
101110101011111111101
100010100010000000101
101110111010111110101
100000100010000010001
101111111110111011101
101000000010100010101
101111101011101110101
100000001000001000000
111111111111111111111
