111111111111111111111
001000001000000000001
101011101011111011101
101000101000001010001
101110111110111010111
100010000000100010001
111011111111101111101
101000000000001000101
101111111111111010101
100000000010100010101
101111101010101011101
100000101000101000101
111110101111101110101
100000100010001000101
101111111010111010101
101010000010001010101
101010111111101011101
101010100000001000001
101010101111111111111
100010000000000000000
111111111111111111111
