111111111111111111111
001000000000001000001
101011111111101111101
101010000010001000001
101011101110111011111
101000100000100010001
101110101111101110101
101000101000100000101
101011101010101111101
100010101010101010001
111110101010101010111
101000001010100010001
101011111011111011101
101010001000001000101
101010101010111011101
101010101010000010001
101010111011111110111
100010000000100010001
101111111111101011101
100000000000001000000
111111111111111111111
