111111111111111111111
000000001000001000001
111111101110101111101
100000001000100000001
101111111011111111101
101010000000000010101
101010111111111010101
101000100000100010001
101011101110101111111
101000101010100010001
101111101010101010101
100000001000101010101
111111111011101010101
100000001010101010101
101111111010101010101
100000100010001000101
101110101111111111101
100010101000000000001
111010101011111111101
100010000010000000000
111111111111111111111
