111111111111111111111
000010000000001000101
111011111110101010101
100010000010101010001
101110111010101011111
101000001000101000001
101111101111101111101
100000101000001000101
111110101011111010101
100010001010000010001
101011111010101111101
101000101010101000101
101110101010111010111
101000001010000010001
101011111010111111101
101010000010001000001
101010111111101011101
101010100010001010101
101110101011111010101
100000001000000010000
111111111111111111111
