111111111111111111111
000000001000001000001
111111101110111010111
100000100010000010001
101011111011101111101
101010001000100010001
101010101110111110111
101000100010000010001
101111101111111011101
101000101000000010001
111010101011111110101
100010001000000000101
101111111111111111101
100000000000000000101
101111111011111111101
100010001010000000101
111010111010111110101
101010100010100010001
101010101110101011111
100000100000001000000
111111111111111111111
