111111111111111111111
000000100000100000001
111110101111101111101
101000100000101000101
101011111110101010101
101010000010001010101
101011101011111010101
101000001000001010101
101111111111101010101
100000000000100010101
101110111110111110101
101010000010100010101
101011111010101010101
100010001010101010001
111010111010111011101
100010001010000010001
101111101011111110111
101000001000000000101
101011101111111111101
100010000000000000000
111111111111111111111
