111111111111111111111
001000100000000010001
101010101111101010101
101010000010001010101
101111111110111011101
100000000010101000001
111111111010101111101
100000001000100000001
101110111111101111111
101010000000100010001
101011111011111011101
101000001000100010001
101111101110101110101
100000001000101000101
111111101011101011111
101000001010001000001
101011111010111111101
100010100010100000101
101110101110101110101
100000100000001000000
111111111111111111111
