111111111111111111111
001000000010000000001
101011101010111111101
101010001010100000001
101110111011101111101
100010101000101000001
111010101110101011111
100010100010001010001
101110101111111010111
101000101000000010001
101011101011111110101
100010100010000000101
111110101111111111101
101000001000000010001
101011111110111010101
101000100000100010101
101110101111101110111
100010100010100010001
101110111010111011101
100000000010000000000
111111111111111111111
