111111111111111111111
001000000000001000001
101110111111101010111
100010000000100010001
111011111110111111101
101000100010100010001
101110101010111010111
100010101010000010001
101110101011111011101
100010101000000010001
101010101111111110111
101000101000000010001
101111111011111011101
100000000010001000001
111111111110101111101
100000000000100000101
101111111011111110101
101000101000001000101
101010101111101111101
100010000000100000000
111111111111111111111
