111111111111111111111
001000001000001000001
101011101010101011101
100010001010101010001
111110111110101110101
100010000010100000101
101111111010111111101
100000001000100010001
111011111111101010111
100010000000001010001
101110111110111111101
100000000010001000001
101111111011101011111
101000001010001000101
101011101110101110101
101000100000101000101
101110111111111011101
101010000000001010001
101011111111101010101
100000000000100000100
111111111111111111111
