111111111111111111111
001000000000100000101
101111101010101110101
100000101010101000101
111110101010101011101
100010101010001010001
101010111011111011101
101010000010001000101
101111111110111110101
101000000010000010001
101010111110111011101
100010100010001000101
101110101011101110101
100010001000000010101
111011111111111110101
101010000010000010101
101011111010111010101
101000100010100000101
101110101010111111101
100000001010000000000
111111111111111111111
