111111111111111111111
001000000000000000001
101011111011111111101
101000001010000000101
101111101010111110101
101000001010100000101
101110111010101111101
100010100010100000101
111011101110111110101
101000100010000010001
101110111011111011111
100010100010001010001
101010101111101010101
101010101000001000101
101110101010111111101
100010101010000010001
101010101011111010111
101010001000101010001
101011111110101011101
101000000000001000000
111111111111111111111
