111111111111111111111
000000100000100000001
111110101110111011101
100010001010001010001
111011111011101010111
100000101000001010001
101110101011111011101
101000001000101010001
101111101110101010111
100000101000100010001
101110111011111111101
101010001010000000101
101011101010111110101
101000101010100010101
101010101010111010101
101010101010001010001
101110101011101011101
101000101010001010001
101010101010111010111
100010100000100000000
111111111111111111111
