111111111111111111111
001000000000100000001
101111111011101011111
100010000010001000001
111010111110111111101
100010001000100000001
101111101011101111101
100000100000101000101
111110101111101011101
100000100010001000001
101111111010111011111
101000100010001000101
101010101111101110101
101010001000101000001
101011111110101111101
101000001000100000101
101111101010111110111
101000100010100010001
101010111111101011101
100010000000001000000
111111111111111111111
