111111111111111111111
001000001000000000001
101011101011111110101
101010101000100010101
101010101111101011101
100010001000001000001
111110111011111111101
100010100010000000001
101010101011111111111
101000101000100000001
101111101110101111101
101000100010000010001
101011101111111010101
101000101000001010101
101010101011101110111
101010101010100010001
101010101010111010101
101010001010001010101
101111111010111011101
100000000010000000000
111111111111111111111
