111111111111111111111
001010000000100010001
101010101110101010101
101000101010101000101
101111101010111111101
100000101000000000001
111110101111111111101
100010100000100000001
101010111110111111111
101010000010000000001
101011111011111111101
101010000010000000001
101110111110111111101
100000100010100000101
101111101010101011101
100000101000101010001
111110101111101110111
100010100010001000101
101110111010111011101
100000000010000000000
111111111111111111111
