111111111111111111111
001000000010000000001
101110111011101111101
100010101000001000001
111010101111111011111
101000101000001000001
101111101011101111101
100000100010100010001
101110101110111010111
100010101000001000101
111010101011101111101
101010001010100000001
101011111010111111101
101010000010000010001
101010111110111010111
101010100010001010101
101010101011101010101
100010101000001000101
101110101111111111101
100000100000000000000
111111111111111111111
