111111111111111111111
000010000010000000001
111011101010111111101
101010001010100010001
101010111010111010101
101010001010000010101
101010101010111110101
101010101010100010101
101010101110101010101
101010100000101000101
101011101111101111111
101000100000100010001
101110111110111010101
100010100010001000101
101010111010111111101
101010001000100000001
111011101111101111101
100000100000101010001
101111111110101010111
100000000000001000000
111111111111111111111
