111111111111111111111
000000100000100000001
111110111110101111101
100010000010001000101
111011111010111110101
100000101010000000101
101110101010111111101
101010101010100000001
101010101011101111101
101000001000001010001
101111101111111010111
100010000010000010001
111011111110101111101
100010001000100000101
101110101011111110101
100000101000100010001
101111101110111011111
101000100000100010001
101010111111101010101
100010000000001000100
111111111111111111111
