111111111111111111111
001000000000000000101
101011111011111110101
101000001010001000001
101111101010101111101
101000001000100000101
101110111111111110111
100010000000001010001
111011101111101011101
101000101000100000101
101110111010101111101
100010100010101000001
101110101110111011101
101000101010001010001
101011101011101011111
100010001010001000001
101110111010111111101
101000100010100000001
101011101110101111101
100010000000001000000
111111111111111111111
