111111111111111111111
000000001000000000001
111111101011111111101
100010001010000010001
101010111010111010111
101000100000001010101
101111111111101010101
101000100010001010001
101010101011111011101
100010001010000010001
111111111010111110111
100000000010000010101
101111111110111010101
101000000010001010001
101111101011101011101
101000101010001010101
101010101010111010101
100010101000100010001
111110111111101110111
100000000000001000000
111111111111111111111
