111111111111111111111
000010000000000010001
111010111110111010101
100010000010100000101
101111111010111111101
101000100010000000101
101010111110111110101
100010100010001010101
111110101011101010101
100010101000100010101
101010101110111110101
101010001000100000101
101111111011101111101
100000000010001000001
101111111110111011111
100000001000100000101
111111101010111110101
100000101010001010001
101111101111101011101
100000000000001000000
111111111111111111111
