111111111111111111111
000000000010001000001
111111111010101110101
100000100010100010101
101111101110111010101
101000001000001000101
101011111011101111111
101010000010100010001
101011111010111010101
101010001000001000101
101010101111111011101
100010100000001010001
101110111111101110111
101000000000100010001
101111101110111011101
100000101000101010001
111110101011101010111
100010101010001010001
101110111010101011101
100000000010100000000
111111111111111111111
