111111111111111111111
001000100000100000001
101010101010111011101
100010101010000010101
111110101011111110101
100010101010000000101
101110101011101111101
101000101000100000101
101011111110101110101
101000001000101000101
101111101011111011101
100010001000001000001
101110111011101111111
100010100000100000001
111010111110111111101
100010100010100010001
101010101010111010111
101010001010000010001
101111111011111111101
100000000000000000000
111111111111111111111
