111111111111111111111
001010000000000000001
101010111111111011101
101010100000100010101
101010101011101110101
101000001010001000101
101011111110111011101
101010000000101000001
101110111111101011111
100010001000001000001
111010101110101111101
100010100010100000101
101111111010111111101
101000000010000000001
101110111110111111111
100010100010000000001
111010111011111111101
100010100000001000101
101110101111111010101
100000100000000010000
111111111111111111111
