111111111111111111111
001000000000001000101
101110111111101010101
100000100000100010001
111111111110111111101
100000000010000010001
111110111010111010111
100000100000100010001
101111111011111011101
100000001010001010001
101111101010101110111
100010101010100010001
111010101110111011101
100010101000101000001
101110101011101111111
100000100010000000101
111110111110111110101
100010100010001000101
101110101011101011101
100000001000001000000
111111111111111111111
