111111111111111111111
001000000010000000001
101011111110101111101
101000001000100000101
101110101011111110101
100010100000000010101
111010111111111010101
100010101000100010101
101110101010101110101
100010001010101000101
111010111010111011101
100010100010001010101
101110101111101010101
101000100000100010101
101011111110111110101
101000001000101000001
101011111011101011111
101010001010001010001
101110101010101010101
100000100010100000100
111111111111111111111
