111111111111111111111
000000100000000000001
111110111111101011101
100010001000101010001
101011101010111011101
101000100010001000101
111010111111101010111
100010100000101010001
101111101011101011101
101000101000101010001
101010101110101110101
100010001000100010101
101111111011111010111
101000001010001010001
101011101010101011101
100010001000100010001
111110111111111110101
101000100010000000101
101011101011111011101
100000001000000010000
111111111111111111111
