111111111111111111111
001000000000000010001
101110111110111011101
100010001010100010001
111011101010111010101
100010000010001010101
101110111111101010111
101000100000101010001
101110101110101011101
100010101000001010001
111011101111111010101
101000100000101000101
101110101110101111101
100000100010101000101
101111111010101010101
101000000010101010001
101111111110101011111
100010000010100010001
111010111010101110101
100000100000100000100
111111111111111111111
