111111111111111111111
000000100000000000001
111110111110111111101
100010000000100000101
101011111111101011101
101000100000101000001
111011101010101111111
100010001010101000001
101110111010101011101
100000001010101010101
101111111011101010101
101000100010001010101
101110101110111010101
100010100000100000101
111010111111111111101
101000100000000000101
101110101111101110101
100010101000001010101
101110111011111010101
100000000010000000000
111111111111111111111
