111111111111111111111
001000100000001000001
101011101011101111101
101000001000100010001
101011111110111010101
101000100000100010101
101111101111101110111
101000101000101010001
101010101011101010101
100010101000101000101
111110101010101111101
100010001010001000001
101111111011111011101
100000001000100000101
111110101110111010101
100000100010001010101
101111111111101010111
100000001000101010001
101111101010101111101
100000100010000000000
111111111111111111111
