111111111111111111111
000010000000000000001
111011101111111111101
100010001000100000101
101110111010101011101
100000101010001000001
111111101011111111111
101000000010001000101
101011111110101010101
101010000000100010001
101011111011111111101
101000100010000010101
101110101110111010101
100010100010101010001
101110101010101010111
100000101000001010101
101111111111101010101
101000000010001010101
101011111011111010101
100010000000000010000
111111111111111111111
