111111111111111111111
000000100000100000001
111110101111101111101
100000101000001010001
101111101011111010101
100000100000100010101
111110111110101010101
100010001000101010101
101011101011101010111
101000101000001010001
101110101111111011101
100010101000000000101
111110101110111111101
100000100010001010001
101011111011101010111
101010000010000010001
101110111111111110101
100010000000100010101
101011111110101011101
101000000000001000000
111111111111111111111
