111111111111111111111
000010000010000000001
111010111010111111101
101010100010001000101
101010101111101011101
101000100010001000001
101111111010111111111
100000001010100000001
101111101010101111101
101000001010101000101
101011101010101011101
101000101010101010001
111110101010101010111
100000101010000010001
101111101011111111101
100000101000001000101
111110101111101010101
100000100000100010001
101111111111111111101
100000000000000000000
111111111111111111111
