111111111111111111111
001000000000100000001
101111101111101110101
100000100000000010101
111110101111111110101
101000100000100000101
101011111111101111101
101000000000100010001
101111111110111011111
100010100010001000001
101010101011101111101
101000101000100000001
101111101110111111101
100000001010000000101
101111111011101111101
101000001000101000001
101110101011101011111
100000101000100010001
111111101110111111101
100000000000000000000
111111111111111111111
