111111111111111111111
000010100000001000001
111010101011101110101
101010001000100000101
101011111110111111101
101010000010100000101
101010111010101111101
101000101000100000001
101111101111101111111
100000000000101000001
111011111111101111101
100010000000001000101
101010111111111010101
101010000010000010101
101111111010111110101
101000001000100010101
101011101111101110101
101010100000100010101
101010111011101010101
100000001000001000000
111111111111111111111
