111111111111111111111
000000100000000000101
111110111111101110101
100010000000001000101
111011111111111011101
100000000000001000001
101111101111101111101
101010001000100010101
101010111010111010101
101000101010001000101
101110101011101111101
100010001000100010001
101011101110111010111
101000100010001010101
101110111111101010101
101010000010001000101
101011111010111111101
100010001010100010001
111010101010101011101
100000101000001000000
111111111111111111111
