111111111111111111111
001000000000001000001
101011111011101111101
101010001010100000101
101011101010111110101
101010001010000010001
101010101010101111101
101000101010100000101
101011111010111110101
101010001010000010001
101110101011111011111
100000101000101010001
111111101010101010111
100000001010101010001
101111111010101010101
100000100010100010101
111110111110101110101
100010100000101000101
101110101111101111101
100000001000000000000
111111111111111111111
