111111111111111111111
000000100000100010001
111110111010101011101
100010100010001000101
101010101111111110101
101010001000001010001
111011111010101011101
100000100010100010101
101110101110111010101
101000100010001000101
101110111011101110101
100010101010101000101
101010101010101111101
101010001010101000101
101011101010101010101
101010001000101010101
101011111110101010101
101000100010101010101
101110101010101010101
100010001000100010000
111111111111111111111
