111111111111111111111
001000000000000000001
101110111111111111101
100000100000000010001
111111101111101110111
100010000010001000101
101110111110101011101
100010101000101010001
101010101010111010111
101010001010100010001
111011101010101110101
100000101010100010101
101111101011111011101
101000001010000010001
101011111010111110111
101010000010001000001
101010111111101011101
100010000010001010001
101111111010111110101
100000001000000000100
111111111111111111111
