111111111111111111111
000000100000000000001
111110111110111111101
100010001000101000001
101011101011101011111
101000001000101000001
101111111010101111101
100010000010100000101
111011111010111011101
100010001010001010001
101110101011101010111
101000101010001010001
101011101110111011101
100010100000100000101
111110111111101110101
101000001000101010101
101011101010101010101
100010101010001010101
101110101011111010101
100000100000000010000
111111111111111111111
