111111111111111111111
000000001010000000101
111111101010111010101
100010001010100010101
101110111010101110101
100010100000100010001
111010111111111011101
100010001000000010101
101111101011111110101
100000101010000000101
111110101010111110101
100000101010100000101
101110101011101111101
101000100010001000101
101111111110111010101
100010000010000010001
101010101110111111111
101000100010001000001
101111111011101011101
100000001000000010000
111111111111111111111
