111111111111111111111
000000100000000000001
111110111110111111111
100010100010001000001
101110101011101011101
100000101010001010001
101111101010101010111
101000001000101010001
101111101111111011101
100000100000001010101
111110101111101010101
100010101000100000101
101010101010111111101
101010101010100000001
101010101010101111101
101010100010101000101
101010111111101011101
101010000000101010001
101011111110101010111
101000000000001000000
111111111111111111111
